###S################
#   #   # ###      #
### # # # ### ## ###
#   # #   ### ## # #
# ### # #######  # #
# #   # #   ### ## #
# # ##  # #      # #
#   ## ## ### ## # #
# #### ## ##  ## # #
# #### ## ## # #   #
# ## #    ## # # # #
# ## # ## ## # # # #
#    # ## #### # # #
# #### ## ##     # #
# #    ## ## # ### #
# # ## ## ## # ### #
# # ## #  ## # ### #
# # ## ## ## # ### #
#  ###     # #     #
############E#######
