***S****************
*   *   * ***      *
*** * * * *** ** ***
*   * *   *** ** * *
* *** * *******  * *
* *   * *   *** ** *
* * **  * *      * *
*   ** ** *** ** * *
* **** ** **  ** * *
* **** ** ** * *   *
* ** *    ** * * * *
* ** * ** ** * * * *
*    * ** **** * * *
* **** ** **     * *
* *    ** ** * *** *
* * ** ** ** * *** *
* * ** *  ** * *** *
* * ** ** ** * *** *
*  ***     * *     *
************E*******
