***S****************
*** *   *          *
*   *            ***
*   * *   *** ** * *
* *** * ***** *  * *
* *   * *    ** ** *
*       *        * *
*      **  **    * *
* **** **  *  ** * *
*    *     * * *   *
*    *    ** * *   *
*    * ** **** * * *
*    * ** ****   * *
* ****  * **     * *
* *     * **   *** *
* *    **  * * *** *
* *    *   * *     *
*  *       * *     *
*  ***     * *     *
************E*******